8
10
B#########
.#E..#...#
.#.#.#.#.#
...#.#.#E#
###.E..#.#
#...##...#
#.E#...#E#
####E#####