12
12
B.##########
#.#........#
#.#.######.#
#.#.#......#
#.#.#.######
#.#.#.#....#
#.#.#...##.#
#.#.########
#.#....#EEE#
#.####.#EEE#
#......#EEE#
############