15
14
B...##########
###.###E##...#
#E#...#.##.#.#
##..#.#..#E#.#
...##.##.###.#
#.##...#.###.#
#.#..#.E.....#
#.#.########.#
#...#E##...#.#
#.#E####.E.#.#
#.#....#...#E.
#.#.#..#####.#
#.#.#.######.#
#...#....E...#
###E##########